//comment
//NAME: Level 2
#################
#################
##########R######
###R#############
#################
###############R#
#######T#####GGG#
#####GGGGG##G####
I###G#####GG#####
GGGG#############
#################


